##########
#   #    #
# #   ## #
#  ## ####
# ###   ##
#   ### ##
# #   #  #
# # # ## #
#   #    #
##########